....................
.1111111E....111111.
.1...........1....1.
.11111111....1....1.
........1....1....1.
.....S..1....1....1.
.11111..1...11....1.
.1......1...1.....1.
.11111..1...1..1111.
.....1..1...1..1....
.....1..1...1..1....
.11111..11111..1111.
.1................1.
.1.11111111.......1.
.1.1......1..111111.
.1.1......1..1......
.1.111..111..1111...
.1...1..1.......1...
.11111..111111111...
....................
