....................
.111111111111111111.
.1................1.
.1..111111........1.
.B111....1.....111J.
.1.......1111111..1.
.1................1.
.1..111.1111.111..1.
.B111.1.1..1.1.111J.
.1....111..111....1.
.1................1.
.1..111111111111..1.
.1..1..........1..1.
.1..1111J1111..1..1.
.1......1...1..1..1.
.1......1...1..111J.
.B1111..1111B.....1.
.1...1......1.....1.
.S...11111111.....E.
....................